20 15 30 100
$..........................
$.......................##
$..$.$..................##
........................##
........................##
..........................
..........................
.......#..#...............
..........................
..........................
................###########
.............###..........
.$........##..............
...###.......$$$..........
