20 15 30 40
...........................
........................##
........................##
........................##
........................##
..........................
..........................
..........................
..........................
..........................
................###########
.............###..........
.........###..............
...###....................
