20 20 30 30
$...................
$1.....2............
$##...##............
$..www..lll....a....
.............o......
$$$wwwlllaaa###.....
