20 20 30 30
$...................
$1.....2...o........
$##...##............
$..www..lll..aaa....
....................
$$$wwwlllaaa###.....
